00000000
0######0
0#**@*#0
0#b####0
0#*#0000
0#e#0000
0###0000
00000000