00000000
00000000
0######0
0#@***#0
0#**be#0
0#*eb*#0
0######0
00000000