00000000
0#####00
0#@**##0
0#ebc*#0
0#**#*#0
0#****#0
0######0
00000000