00000000
######00
#@***##0
#*bb**#0
#*#e*e#0
#*****#0
#######0
00000000