00000000
00####00
###**#00
#@*eb##0
#***b*#0
#*#e**#0
#*****#0
#######0