00000000
0#####00
##@**##0
#**#**#0
#*bcb*#0
#**e**#0
##*e*##0
0#####00